sStats = STATS
sStatsCrippled = CRIPPLED
sStatsEFFAbbrev = EFF
sStatsLVLAbbrev = LVL
sStatsHP = HP
sStatsAP = AP
sStatsXP = XP
sStatsCNDAbbrev = CND
sStatsRADAbbrev = RAD
sStatsH20Abbrev = H20
sStatsFODAbbrev = FOD
sStatsSLPAbbrev = SLP
sStatsRadResist = RAD RESIST
sStatsNoEffects = NO STATUS EFFECTS
sStatsGeneral = General
sStatsSpecial = S.P.E.C.I.A.L.
sStatsStatus = Status
sStatsAddicted = ADDICT
sStatsAlcohol = Alcohol
sStatsRadiation = Radiation
sStatsPerks = Perks
sStatsSkills = Skills
sInventoryWeight = Wg
sHitPointsShort = HP
sInventoryDamageResistance = DR
sInventoryDamageThreshold = DT
sInventoryCaps = Caps
sInventoryItems = ITEMS
sInventoryRepair = Repair
sInventoryMod = Mod
sInventoryDamagePerSecond = DPS
sInventoryWeightUpper = WG
sInventoryValue = VAL
sInventoryCondition = CND
sInventoryDamage = DAM
sInventoryStrReq = STR
sInventoryEffects = EFFECTS
sData = DATA
sTravel = Travel
sMakeActiveQuest = Make Active Quest
sPlayAudio = Play Audio
sTune = Tune
sStopAudio = Stop Audio
sPlaceMarker = Place Marker
sShowLocation = Show Location
sShowAllNotes = Show All Notes
sShowActiveNotes = Show Active Quest Notes
sNextChallenge = Next Challenge Type
sChallengeToggle = Challenges
